1 1 1 1 2 0 0 0 0 0 0 3 1 1 1 1
2 6 6 6 6 0 0 0 0 0 0 6 6 6 3 1
2 5 5 5 5 0 0 0 0 0 0 5 5 5 3 1
2 0 0 0 0 0 0 0 0 0 0 0 0 0 3 1
6 0 0 0 0 0 0 0 0 0 0 0 0 0 3 1
5 0 0 0 0 0 0 0 0 0 0 0 0 0 3 1
0 0 0 0 0 0 0 0 0 0 0 0 0 0 3 1
0 0 0 0 0 0 0 0 0 0 0 0 0 0 3 1
4 8 0 0 0 0 0 0 0 0 0 0 0 0 3 1
1 2 0 0 0 0 0 0 0 0 0 0 0 0 3 1
1 1 4 4 4 4 4 4 4 4 4 4 4 4 1 1
1 1 1 1 1 1 1 1 1 1 1 1 1 1 1 1